0000000000
0 1      0
0 1122   0
0    3   0
0     3  0
0   22   0
0    3   0
0  1321  0
0        0
0000000000